你能到另一个吧台这边来吗？	create_sub_task	{At(Robot,Bar2)}	当然可以，我现在过去，请您稍等
哈喽！服务员，在吧台那里借用下充电宝行不行?	create_sub_task	{At(Robot,Bar)}	没问题!我马上就过去.
麻烦拿个空杯子过来。	create_sub_task	{At(Robot,WaterTable)}	没问题，马上给您拿一个空杯子过来。
你好，我想点一杯咖啡。	create_sub_task	{At(Robot,Table3)}	当然，请稍等片刻，我马上为您准备。
你好，请问有没有空位？	create_sub_task	{At(Robot,Table1)}	是的，我们还有空座位。请随意选择一个位置坐下即可。
Hi! there! Could you bring me a milkdrink? Thankyou!	create_sub_task	{On(MilkDrink,CoffeeTable)}	Certainly! I will bring it to you right away.
请将甜点和牛奶饮料放到2号桌上。	create_sub_task	{On(Dessert,Table2),On(MilkDrink,Table2)}	好的，甜点和牛奶饮料将马上送到2号桌上。
请把AD钙奶放到咖啡台上。	create_sub_task	{On(ADMilk,CoffeeTable)}	好的，马上为您放置AD钙奶。
请给我一瓶瓶装冰红茶，我在旁边的吧台这里。	create_sub_task	{On(BottledDrink,Bar2)}	好的，我会马上为您准备一瓶瓶装冰红茶。
请给我来杯酸奶，在吧台处。	create_sub_task	{On(Yogurt,Bar)}	当然可以，请稍等片刻，我们将为您准备杯酸奶并放置于吧台处。
可以打开大厅灯并且关掉筒灯吗?	create_sub_task	{Is(HallLight,On),Is(TubeLight,Off)}	当然,我会打开大厅的灯并关闭筒灯.
请打开空调并调低温度。	create_sub_task	{Is(AC,On),Is(ACTemperature,Down)}	好的，空调已经打开，并且温度已经调低了。
你好，能不能给我整理一下这边的椅子？	create_sub_task	{Is(Chairs,Clean)}	当然，请稍等片刻。
可以帮我打开空调吗？这里太热了。	create_sub_task	{Is(AC,On)}	当然可以，我会为您打开空调并将温度降低到适宜的程度。
这里太暗了，你能帮我打开筒灯吗？	create_sub_task	{Is(TubeLight,On)}	当然可以，请稍等片刻。马上为您打开筒灯。
请给我一个酸奶。	create_sub_task	{Holding(Yogurt)}	好的，请稍等片刻，马上就会有酸奶送到您手中。
我想要酸奶和牛奶饮料/真果粒	create_sub_task	{Holding(Yogurt),Holding(MilkDrink)}	当然可以。这是您的酸奶和牛奶饮料/真果粒。享用吧！
抱歉打扰了，请问有什么推荐的甜点吗？	create_sub_task	{Holding(Nothing)}	当然！我们有很多美味的甜点供您选择。让我向您介绍一下...
可以帮忙递给我那瓶瓶装冰红茶吗？	create_sub_task	{Holding(BottledDrink)}	没问题，这是您要的瓶装冰红茶。
你能给我一个保温杯吗？	create_sub_task	{Holding(VacuumCup)}	当然，这是您的保温杯。
只需要打扫地板就行了，在这里喝我的咖啡。	create_sub_task	{On(Coffee,Bar2),Is(Floor,Dirty)}	当然没问题！让我们先打扫地板再享受你的美味咖啡吧！
在这个桌子上放置我的咖啡之前能帮忙把它清理下吗？	create_sub_task	{On(Coffee,Bar2),Is(Table1,Dirty)}	当然没问题！让我们先将桌子清洁干净再放置您的咖啡。
你好!可以给我一个甜点吗?	create_sub_task	{On(Dessert,CoffeeTable)}	当然!我会为您准备一个甜点.
你好，请给我来杯咖啡。可以从吧台那里拿过来吗？	create_sub_task	{On(Coffee,Bar)}	当然，请稍等片刻。让我为您准备一杯咖啡并放在吧台上供您享用。
嘿，在吧台那里有甜点。麻烦拿一个过来。	create_sub_task	{On(Dessert,Bar)}	当然，请稍等片刻，我会为您取一个甜点过来。
请问这里有没有牙膏?	get_env_info	牙膏，None	不好意思，我们是咖啡厅，暂时没有提供牙膏。如果您需要的话，可以去附近的超市购买。
你们这里卫生纸用完了吗?我需要拿几张。	get_env_info	卫生纸，柜台	非常抱歉，目前我们暂时缺货。但是您可以在柜台处领取湿巾来代替使用。给您带来不便深感抱歉。
我想要一杯Bernachon牛奶热巧克力,这里能做得到吧?	get_env_info	Bernachon牛奶热巧克力，咖啡机	非常抱歉，我们的咖啡机暂时不支持制作Bernachon牛奶热巧克力。但是您可以尝试其他口味的饮品或者选择其他喜欢的热巧克力。
请问我可以用洗手间吗?	get_env_info	洗手间（卫生间）	卫生间门旁边的走廊上方指示牌上标注了“卫生间”字样。当然可以，请沿着卫生间门旁边的走廊前行即可看到指示牌。
请问这里有面包卖吗?	get_env_info	面包，橱柜	是的，我们这里有面包出售。您可以去橱柜那边看看，选择自己喜欢口感和口味的面包哦！
我要买蛋糕,能告诉我蛋糕柜在哪里吗?	get_env_info	蛋糕柜，吧台	当然可以！如果您想要购买蛋糕,我们的蛋糕柜就位于咖啡厅的吧台旁边.您只需要沿着吧台走一小段路,就能找到我们精心准备的美味甜点了.希望您享受这个愉快而甜蜜的时刻!
请问冰箱在哪里?我需要存放我的食物。	get_env_info	冰箱，橱柜	非常抱歉，我们咖啡厅并没有提供冰箱来为客人存放食物。不过您可以将食物交给服务员，并告知他们需要保存的时间和要求，他们会为您做好安排。
我想找一个舒适的沙发坐一下，能告诉我在哪里吗?	get_env_info	沙发，休闲区	当然可以！我们咖啡厅内设有专门供客人使用的舒适沙发，您可以前往咖啡厅中央附近的休闲区寻找。
你们这里提供免费Wi-Fi服务吗?我需要上网工作。	get_env_info	无线网络，服务台	当然！我们提供免费Wi-Fi服务给所有顾客使用。最接近无线网络信号强度最高处是在服务台周围,如果您需要连接互联网进行工作或其他事情，请尽管前去。
请问这里有没有香柜?	get_env_info	香柜	非常抱歉，我们这里暂时没有提供香柜服务。不过您可以在附近的商店中寻找哦。
能告诉我今天特别推荐哪种咖啡吗？	—	—	今天特别推荐我们自家调配的手冲单品咖啡。每日精选不同产区豆子，在专业师傅细心烘焙后现场为您沏制出最佳风味。
请问你们在什么时间段营业？	—	—	我们从早上8点开始营业到晚上10点结束。欢迎随时来店享用美味的咖啡和舒适环境。
今天下午来得人很多,我需要等很久吗？	—	—	很抱歉给您带来不便。由于人流较多，可能会有一些等待时间。我们会尽快为您提供服务，请耐心稍候。
请问你们还接受支付宝或微信支付吗？	—	—	是的，我们支持支付宝和微信支付两种方式。方便快捷地完成付款流程，并确保了安全性。
请问附近是否有停车场？如果没有，那么最近哪个停车场离得比较近？	—	—	很抱歉，在咖啡馆周围暂时没有专门停车场。但距离不远处就有一个大型商业中心停车场可供选择。
